


  |  |  |  |  |  |  |GR|  |  |  |  |  |  |GR|  |GR|GR|  |  |GR|  |  |  |  |  |  |  |  |  |  |  |  |  |  |  |  |  |  |  |  |  |  |  |  |  |  |  |  |  |  |CA|  |CA|  |CA|CA|CA|  |CA|  |CA|  |CA|CA|CA|  |CA|  |  | 	|CA|CA
  |  |  |  |  |GR|  |GR|  |  |  |  |  |  |  |  |  |  |  |  |  |  |  |  |  |GR|  |  |  |  |  |  |  |  |  |  |  |  |GR|  |  |  |  |  |  |  |  |  |  |  |  |CA|CA|CA|  |CA|  |CA|  |CA|CA|CA|  |CA|  |CA|  |CA|  |  | 	|CA|CA
  |  |  |  |GR|GR|  |GR|GR|  |  |  |  |  |  |  |  |  |  |  |  |  |  |  |  |GR|GR|  |  |  |  |  |  |  |  |  |GR|GR|GR|GR|  |  |GR|GR|GR|GR|  |  |  |  |  |CA|  |CA|  |CA|CA|CA|  |CA|  |CA|  |CA|CA|CA|  |  |  |  |  |CA|CA
  |  |  |GR|GR|GR|  |GR|GR|GR|GR|GR|GR|GR|GR|WA|WA|GR|GR|GR|GR|GR|GR|GR|GR|GR|GR|GR|GR|  |  |  |  |GR|GR|  |  |  |GR|GR|GR|GR|GR|GR|GR|GR|GR|GR|GR|GR|  |CA|  |CA|  |CA|  |CA|  |CA|  |CA|  |CA|  |CA|  |CA|  |	 |	|CA|CA
  |  |GR|  |  |  |  |GR|  |  |  |  |  |  |GR|  |GR|GR|  |  |GR|  |  |  |  |GR|  |  |  |  |  |  |  |  |  |  |  |  |  |  |  |  |  |  |  |  |  |  |  |  |  |CA|  |CA|  |CA|CA|CA|  |CA|  |CA|  |CA|CA|CA|  |CA|  |  | 	|CA|CA
  |  |  |  |  |  |  |  |  |  |  |  |  |  |GR|  |GR|GR|  |  |GR|  |  |  |  |  |  |  |  |  |  |  |  |  |  |  |  |  |  |  |  |  |  |  |  |  |  |  |  |  |  |CA|  |CA|  |CA|CA|CA|  |CA|  |CA|  |CA|CA|CA|  |CA|  |  | 	|CA|CA
  |GR|  |GR|  |  |  |  |  |  |  |  |  |  |  |  |GR|GR|  |  |GR|  |  |  |  |  |  |  |  |  |  |  |  |  |  |  |  |  |  |  |  |  |  |  |  |  |  |  |  |  |  |  |  |CA|  |CA|CA|CA|  |CA|  |CA|  |CA|CA|CA|  |CA|  |  | 	|CA|CA
GR|GR|  |  |  |  |  |  |  |  |  |  |  |  |  |  |GR|GR|  |  |GR|  |  |  |  |GR|  |  |  |  |  |  |  |  |  |  |  |  |  |  |  |  |  |  |  |  |  |  |  |  |  |  |  |CA|  |CA|CA|CA|  |CA|  |CA|  |CA|CA|CA|  |CA|  |  | 	|CA|CA
GR|GR|GR|  |  |GR|  |GR|  |  |  |  |  |  |GR|  |  |  |  |  |GR|GR|GR|  |  |GR|GR|  |  |  |  |  |  |  |  |  |  |  |GR|  |  |  |  |  |  |  |  |  |  |  |  |  |CA|CA|  |CA|  |CA|  |CA|CA|CA|  |CA|  |CA|  |CA|  |  | 	|CA|CA
GR|GR|GR|GR|GR|GR|  |GR|GR|  |  |  |  |GR|GR|  |  |  |  |  |  |  |  |  |GR|GR|GR|GR|  |  |  |  |  |  |  |  |  |GR|GR|GR|GR|  |  |GR|GR|GR|GR|  |  |  |  |CA|  |CA|  |CA|CA|CA|  |CA|  |CA|  |CA|CA|CA|  |  |  |	 |	|CA|CA
GR|GR|GR|GR|GR|GR|  |GR|GR|GR|GR|GR|GR|GR|GR|WA|WA|GR|GR|GR|  |  |  |  |GR|GR|GR|GR|GR|GR|GR|  |  |GR|GR|  |  |  |GR|GR|GR|GR|GR|GR|GR|GR|GR|GR|GR|GR|  |CA|  |CA|  |CA|  |CA|  |CA|  |CA|  |CA|  |CA|  |CA|  |	 |	|CA|CA
GR|GR|GR|GR|GR|GR|WA|GR|GR|GR|GR|GR|GR|GR|GR|WA|WA|GR|GR|GR|GR|GR|GR|GR|GR|GR|GR|GR|GR|GR|GR|WA|WA|WA|WA|WA|WA|WA|GR|GR|GR|GR|GR|GR|GR|GR|GR|GR|GR|GR|LA|LA|LA|LA|LA|LA|LA|LA|LA|LA|LA|LA|LA|LA|LA|LA|LA|LA|LA|LA|LA|CA|CA